14 2 2 2 2 2 2 2 2 2 2 2 2 2 2 3
6 1 4 8 8 9 12 8 8 8 8 8 8 0 0 1
5 5 12 10 2 3 14 10 10 10 2 2 10 8 8 1
5 5 6 3 12 9 14 10 2 2 0 8 10 10 2 1
5 4 8 8 11 6 10 10 0 8 9 6 2 2 0 1
5 5 6 2 2 1 7 14 1 6 2 8 8 0 0 1
5 5 5 5 4 0 0 10 8 0 0 2 10 8 8 1
5 5 5 5 4 0 1 14 3 12 8 0 2 10 10 1
5 5 5 5 4 0 0 10 9 6 2 1 5 14 10 1
5 5 4 1 5 4 8 10 10 8 8 9 5 14 10 1
5 13 13 5 13 4 10 10 10 10 10 3 5 6 2 1
5 7 7 4 10 8 10 10 10 3 6 0 8 8 0 1
4 8 8 8 10 10 10 10 10 9 12 8 10 10 0 1
12 10 10 10 10 10 3 6 10 10 10 10 10 10 1 5
6 3 14 2 3 7 5 5 14 10 10 10 10 10 1 5
13 12 10 9 12 8 8 8 10 10 10 10 10 10 8 9
0 1 2 3 4 5 6 7 8 9 10 11 12 13 14 15
