6 10 10 10 10 10 10 10 10 10 10 10 10 10 10 3
5 6 10 10 10 10 10 10 10 10 10 10 10 10 10 1
5 5 14 10 3 7 6 2 3 7 6 2 3 6 3 5
5 5 6 3 4 0 1 5 4 0 1 5 4 1 5 5
5 5 12 8 1 5 4 0 1 5 4 0 1 5 5 5
5 5 6 3 4 0 1 5 4 0 1 5 4 1 5 5
5 5 5 12 9 5 4 0 1 5 4 0 1 5 5 5
5 5 12 10 10 8 9 13 12 8 9 13 12 1 5 5
5 12 10 10 10 10 10 10 10 10 10 10 10 9 5 5
4 10 3 14 2 10 10 3 6 10 10 2 10 10 1 5
4 3 12 3 12 3 15 12 9 15 6 9 6 2 1 5
5 12 3 12 3 12 3 14 11 6 9 6 9 5 5 5
5 15 12 3 12 3 12 3 15 12 10 9 6 9 5 5
12 10 3 12 3 12 3 12 10 10 10 3 5 15 12 9
6 3 12 3 12 3 12 10 10 10 10 9 12 10 10 3
12 8 10 8 11 12 10 10 10 10 10 10 10 10 10 9
0 1 2 3 4 5 6 7 8 9 10 11 12 13 14 15
