6 10 2 10 2 10 2 3 6 10 10 2 10 2 10 3
5 14 8 3 12 10 1 12 9 6 10 8 10 8 3 5
4 10 2 8 10 3 12 10 10 9 6 10 10 10 9 5
12 3 4 3 15 4 10 10 10 3 12 3 6 10 10 1
15 5 5 12 3 4 10 10 10 1 15 5 5 6 2 9
6 9 5 15 12 1 6 10 10 0 10 9 5 5 5 7
4 10 8 10 3 5 5 14 11 12 10 10 9 5 5 13
4 10 10 10 1 5 4 2 3 14 10 10 10 1 12 3
5 7 6 10 8 1 5 12 9 7 15 6 10 9 15 5
5 13 5 14 11 5 12 10 10 8 10 9 6 10 10 1
12 10 8 10 3 5 7 6 2 10 10 3 5 15 6 1
6 10 10 2 1 5 13 5 5 6 10 1 5 6 9 5
5 6 10 9 5 12 10 9 5 5 6 9 5 5 6 9
5 5 6 11 5 15 6 10 9 5 5 7 5 5 12 3
5 5 13 7 12 10 9 6 10 1 5 13 12 8 3 5
13 12 10 8 10 10 10 9 15 12 8 10 10 10 8 9
0 1 2 3 4 5 6 7 8 9 10 11 12 13 14 15
